1111111111111111111
1C0000T1111C00E0001
101T1000000C0T11101
10001T1111110111101
11T011000000001C101
1P001C0001000110001
1111111111111111111