1111111111111111111
1C000011110C00P0001
1011T000000C0111101
1000T11111T10111101
1T10110010000000011
1C001C0000000E100C1
1111111111111111111