1111111111111111111
1C0000T1111C000C001
1011100000000111101
1000111111110111101
111011E100010001001
1P00110001000100011
1111111111111111111