11111111111111111111111111111111111111
1C0000T1111C000C0011C0000T1111C000C001
101T100000000111100001T100000000111101
1C0000T1111C000C0011C0000T1111C000C001
101T100000000111100001T100000000111101
10001T111111011110110001T1111110111101
111011T000T000T0011110110T000T000T0011
10001T111111011110110001T1111110111101
111011T000T000T0011110110T000T000T0011
1000T0000T0001000T11000T0000T0001000T1
11101111111111111111111111111110111111
1C0000T1111C000C0011C0000T1111C000C001
101T100000000111101101T100000000111101
10001T111111011110110001T1111110111101
101T100000000111101101T100000000111101
10001T111111011110110001T1111110111101
111011T000T000T00E1110110T000T000T0011
1P00T0000T0001000T11000T0000T0001000T1
11111111111111111111111111111111111111