1111111111111111111
1C0000T1111C000C001
101T100000000111101
10001T1111110111101
111011ET000T000T001
1P00T0000T0001000T1
1111111111111111111